0,1,2,3,4,5,6,7,8,9,10,11,12,13,14
0,0,0,0,0,0,0,0,0,0,0,0,0,0,0
0,1,1,3,1,3,1,0,1,1,0,0,1,1,0
0,9,0,0,0,0,1,0,1,0,0,0,0,2,0
0,6,0,0,1,1,1,0,1,5,5,5,1,1,0
0,0,0,0,0,0,0,0,0,0,0,0,0,0,0
0,0,0,0,0,0,0,0,0,0,0,0,0,0,0
0,1,1,1,0,0,1,0,1,4,1,4,1,0,0
0,1,0,0,0,0,1,0,1,0,0,0,0,0,8
0,1,2,2,2,2,1,0,1,7,1,1,1,0,0
0,0,0,0,0,0,0,0,0,0,0,0,0,0,0