1,1,6,9,1,1,8,1,1,6,9,1,1,1,1
7,0,0,0,0,0,0,0,0,0,0,0,0,0,7
1,0,0,0,0,0,0,0,0,0,0,0,0,0,1
1,0,0,0,0,0,0,0,0,0,0,0,0,0,3
4,0,0,0,1,0,0,0,0,1,0,0,0,0,1
1,0,0,0,1,0,0,0,0,1,0,0,0,0,1
1,0,0,0,1,0,0,0,0,1,0,0,0,0,3
4,0,0,0,1,0,0,0,0,1,0,0,0,0,1
1,0,0,0,1,0,0,0,0,1,0,0,0,0,1
1,2,2,1,1,5,1,1,5,1,1,2,2,2,1