0,1,2,3,4,5,6,7,8,9,10,11,12,13,14
1,1,5,5,1,1,1,0,1,1,1,5,5,1,1
1,0,0,0,0,0,7,0,1,0,0,0,0,0,1
1,0,0,0,0,0,1,0,1,0,0,0,0,0,1
2,0,0,0,0,0,1,8,1,0,0,0,0,0,2
1,0,0,0,0,0,0,0,0,0,0,0,0,0,2
1,0,0,0,0,0,0,0,0,0,0,0,0,0,2
2,0,0,0,0,0,1,1,1,0,0,0,0,0,1
1,0,0,0,0,0,1,0,1,0,0,0,0,0,1
1,0,0,0,0,0,1,0,1,0,0,0,0,0,1
1,3,3,3,9,6,1,0,1,1,1,4,4,1,1