0,1,2,3,4,5,6,7,8,9,10,11,12,13,14
1,1,2,1,2,2,1,1,1,4,1,4,1,1,1
1,0,0,0,0,0,5,0,0,0,0,0,0,0,5
1,0,0,0,0,0,5,0,0,0,0,0,0,0,1
1,0,0,0,0,0,1,0,0,0,0,0,0,0,5
1,0,0,0,0,0,0,0,0,1,1,1,0,0,7
1,1,1,1,1,1,1,0,0,1,1,1,0,0,1
1,0,0,0,0,0,0,0,0,0,0,0,0,0,1
2,0,0,0,0,0,0,0,0,0,0,0,0,0,1
2,0,0,0,0,0,0,0,0,0,0,0,0,0,8
1,1,1,6,9,1,1,1,1,1,3,1,3,1,1